1948/07/27
1948/07/27
1948/07/27
1948/07/28
2006/02
2007/03
2007/03
2009/06/30
2009/06/30
2009/06/30
2009/06/30
2009/06/30
2009/06/30
2009/11
2009/12
2010/04
2010/12
2011/05
2011/06/19
2011/07/21
2011/08/12
2012/04
2012/04/18
2012/04/18
2013/08/30
2013/11
2013/11/12
2013/11/12
2014/02
2014/06
2014/07/09
2014/07/09
2015/10/01
2015/10/01
2017/02
2017/02
2017/02
2017/02/07
2017/02/07
2017/02/07
2017/02/07
2017/02/07
2017/02/07
2017/02/07
2017/02/07
2017/02/07
2017/02/07
2018/04/03
2018/04/03
2019/07/02
2019/07/02
2019/09/04
2019/09/04
2021/08/31